+ + + + + + + + + + + +
+ - - - - - - - - - - +
+ - - - - - - - - - - +
+ - - + - + - - - - - +
+ - - - + - - - - - - +
+ - - - - - - + + - - +
+ - - - - - - - - - - +
+ - - - + + + - - - - +
+ - - - - - - - - - - +
+ - - - - - - - - - - +
+ - - - - - - - - - - +
+ + + + + + + + + + + +