+ + + + + +
+ - - - - +
+ - - - + +
+ + - - - +
+ - - - - +
+ + + + + +