+ + + + + + + + +
+ - - - + + + + +
+ - - - - - - - +
+ - - - - - - - +
+ - - - - - - - +
+ + + + + + + + +